12 12
############
#@       ###
##   o   ###
####    ####
##     #####
##o   ######
#+  #  #####
#       +###
#   #  #####
## $     ###
###       ##
############
23 36
87