10 10
##########
# $      #
##     o #
####    ##
##   + ###
##@   ####
#   #  ###
#  o    +#
#   #  ###
##########
24 33
6