17 24
########################
#  ### ##   +          #
#            o         #
## ##   #  @          +#
## ##  ##  o     o     #
#########  +        $  #
##  # # #        o     #
##   +   o             #
############        ####
#                      #
#              +       #
#                      #
#                      #
####                   #
#                      #
#                      #
########################
60 57 59 50 60
88